AGD	= "countries/Agder.txt"
AIR	= "countries/Airgialla.txt"
AIL	= "countries/Ailech.txt"
AST	= "countries/Asturia.txt"
BEN	= "countries/Benevento.txt"
BYZ	= "countries/Byzantium.txt"
BRY	= "countries/Brycheinoig.txt"
CAT	= "countries/Cat.txt"
CIR	= "countries/Circinn.txt"
CON	= "countries/Connacht.txt"
COR	= "countries/Cornix.txt"
COU	= "countries/Cornouaille.txt"
DYF	= "countries/Dyfed.txt"
DOM	= "countries/Domnonee.txt"
DUB	= "countries/Dunbar.txt"
DUN	= "countries/Dunoding.txt"
EAS	= "countries/East-Anglia.txt"
ECO	= "countries/Emirate of Cordoba.txt"
ESS	= "countries/Essex.txt"
FIB	= "countries/Fib.txt"
FID	= "countries/Fidach.txt"
FIR	= "countries/Firdaland.txt"
FOR	= "countries/Fortriu.txt"
FOT	= "countries/Fotla.txt"
FRA	= "countries/France.txt"
GLY	= "countries/Glywysing.txt"
GWE	= "countries/Gwent.txt"
GWY	= "countries/Gwynedd.txt"
GWR	= "countries/Gwrtheyrn.txt"
HAR	= "countries/Hardanger.txt"
HOR	= "countries/Hordaland.txt"
HWI	= "countries/Hwicce.txt"
ITA	= "countries/Italy.txt"
KCE	= "countries/Ce.txt"
KEN	= "countries/Kent.txt"
LAI	= "countries/Laigin.txt"
LEN	= "countries/Leon Britt.txt"
LIN	= "countries/Lindsey.txt"
MAN	= "countries/Manaw.txt"
MEI	= "countries/Meirionydd.txt"
MER	= "countries/Mercia.txt"
MHU	= "countries/Mhumhain.txt"
MID	= "countries/Mide.txt"
NAN	= "countries/Nantais.txt"
NAP	= "countries/Napoli.txt"
NOR	= "countries/Northumbria.txt"
PAP	= "countries/Papal State.txt"
POW	= "countries/Powis.txt"
REN	= "countries/Rennais.txt"
RIA	= "countries/Dal Riata.txt"
ROG	= "countries/Rogaland.txt"
SAX	= "countries/Saxony.txt"
SEI	= "countries/Seisyllwg.txt"
SOB	= "countries/Sobrarbe.txt"
SPO	= "countries/Spoleto.txt"
STR	= "countries/Strathclyde.txt"
SUR	= "countries/Surrey.txt"
SUS	= "countries/Sussex.txt"
SYG	= "countries/Sygnaland.txt"
ULA	= "countries/Ulaid.txt"
VAN	= "countries/Vannetais.txt"
VEN	= "countries/Venetia.txt"
VOS	= "countries/Voss.txt"
WES	= "countries/Wessex.txt"
SUN	= "countries/Sunnmore.txt"
RAU	= "countries/Raumsdalr.txt"
NMO	= "countries/Nordmore.txt"
STI	= "countries/Stiordoelariki.txt"
GAU	= "countries/Gauldoelariki.txt"
ORK	= "countries/Orkdoelariki.txt"
STN	= "countries/Strindariki.txt"
EYN	= "countries/Eynariki.txt"
SKE	= "countries/Skeynariki.txt"
NAM	= "countries/Namdariki.txt"
SPA	= "countries/Sparbyggjariki.txt"
EYS	= "countries/Eystridal.txt"
HED	= "countries/Hedmark.txt"
VER	= "countries/Verdoelariki.txt"
VES	= "countries/Vestfold.txt"
HEI	= "countries/Heinariki.txt"
RAM	= "countries/Raumariki.txt"
RIN	= "countries/Ringeriki.txt"
VIN	= "countries/Vingulriki.txt"
ALF	= "countries/Alfheimar.txt"
DAL	= "countries/Dal.txt"
VAR	= "countries/Varmland.txt"
TEL	= "countries/Telemark.txt"
HAL	= "countries/Halogariki.txt"
HAD	= "countries/Haddingjadal.txt"
NUM	= "countries/Numadal.txt"
GUD	= "countries/Gudbrandsdalen.txt"
OPP	= "countries/Oppland.txt"
VAL	= "countries/Valdres.txt"
HAS	= "countries/Halsingland.txt"
NDA	= "countries/Nordanstig.txt"
SUH	= "countries/Sundhead.txt"
JAM	= "countries/Jamtland.txt"
SKO	= "countries/Skoen.txt"
HAJ	= "countries/Harjedalen.txt"
BIR	= "countries/Birka.txt"
SOD	= "countries/Sodermaland.txt"
JAB	= "countries/Jambaraland.txt"
VAS	= "countries/Vastmanland.txt"
NAR	= "countries/Narke.txt"
ROD	= "countries/Roden.txt"
FJA = "countries/Fjardhundra.txt"
ATT = "countries/Attunda.txt"
TIU = "countries/Tiunda.txt"
GAS = "countries/Gastrikland.txt"
WGO = "countries/Westrogothia.txt"
FVN = "countries/Finnveden.txt"
GJE = "countries/Gjesvaer.txt"
SVJ = "countries/Svitjod.txt"
SKA = "countries/Skane.txt"
BLE = "countries/Blekinge.txt"
VRN = "countries/Varend.txt"
MOR = "countries/More.txt"
OLA = "countries/Oland.txt"
GOT = "countries/Gotland.txt"
NJU = "countries/Njudung.txt"
VIS = "countries/Vista.txt"
TVE = "countries/Tveta.txt"
VED = "countries/Vedbo.txt"
KIN = "countries/Kinda.txt"
TJU = "countries/Tjust.txt"
SEV = "countries/Sevede.txt"
ASP = "countries/Aspeland.txt"
HAN = "countries/Handbord.txt"
BOR = "countries/Bornholm.txt"
ROS = "countries/Roskilde.txt"
VDL = "countries/Vendill.txt"
RIB = "countries/Ribe.txt"
HEB = "countries/Hedeby.txt"
ARO = "countries/Aros.txt"
JEL = "countries/Jelling.txt"
OST = "countries/Ostrogothia.txt"
IDR = "countries/Idrisids.txt"
NEK = "countries/Nekor.txt"
AGH = "countries/Aghlabids.txt"
TAH = "countries/Tahert.txt"
ABB = "countries/Abbasids.txt"